111111111111111
1111111111111P1
111111111111EC1
111111111111111