1111111111111111111111111111111111111111111111111111111111111
111111111111111111111111111111111111111111111110E0000000P0001
11111111111111111111111111111111111111111111111C0C000C0000001
1111111111111111111111111111111111111111111111111111111111111